110
00001000000000000000
00001000000000000000
00001000000000000000
00001000000011111100
00001000000000000100
00000000100000000000
00000000100000000000
00000011111000000000
00000000100000000000
00000000100000000000
00000000100000000000
00000000000000000000
00000000000000000000
00001000000000000000
00001000000000001000
00001000000000001000
00001000000000011000
00001001110000010000
00001000000000010000
00001000000000010000