130
00100000000000000000
00100000000000000000
00111000000000000000
00100000000000000000
00100000000000000000
00000000000100000000
00000000000100000000
00000000000100000000
00000000000100000000
00000000111100000000
00000000000000000000
00000000000000000100
00000000000000000100
00000000000000000100
00000000000000000100
00010000000000000111
00010000000000000000
11110000000000000000
10000000000000000000
10000000000000000000