80
00000000000000001000
00000000000000001100
00000000000000000000
00111000110001000000
00000000010001000000
00000000000001000000
00000000000000000000
00000100000000000000
00000100000001000000
11111100000001000000
00000100000011100000
00000100000000000000
00000000000000000111
00000000000000000000
00000000000001000000
00000011100001000000
11100000000001000000
00100000000001000000
00000000000001000000
00000000000001000000