95
00000000000001000000
00000000000001000000
00000000000001000000
11110000000001000000
00000000000001000111
00000000000001000100
00000000000000000100
00000000000000000100
00000000000000000000
11111111110000000000
00000000000000000000
00000000000000000000
00000000000000000000
00000000000000001000
00000000000000001000
00000000000000001000
11111000000000001111
10000000000000000000
10000000000000000000
10000000000000000000